XXXXXXXXXXXXXXXXXXXXX
XpX     X       XkX X
X X X XXX XXXXX X X X
X X X         X     X
X XXX X X XXX XXX XXX
X X   X X   X X   X X
X X XXXXX X XXXXXXX X
X   X   X X         X
XXX X X XXXXXXXXXXX X
X     X X   X       X
X XXXXX XXX X XXX X X
X     X     X X   X X
X XXX XXX XXX XXXXX X
X X   X     X X   X X
X X X X XXX X X X XXX
X X X X X X X X X   X
X X X X X X X X X X X
X   X X   X X   X X X
XXX X XXXXX X XXX XXX
Xm  X       X   X   E
XXXXXXXXXXXXXXXXXXXXX
